f f f f f g w f
f f f f w w w f
f f f f f f f f
w w w w f f f f
f f f w f f f f
s f f f f f f f